B_________________________________________B
B_________________________________________B
B_________________________________________B
BP________________________________________B
B_________________________________________B
B_________________________________________B
B_________________________________________B
B_________________________________________B
B____BB___________________BB______E_______B
B____________Tt___________________B_______B
B_________________________________________B
B____BB___________________BB______________B
B_________________________________________B
B_____________T___________________TB______B
B_________________________________________B
B_________________________________________B
B__________BBBBBBB______________BB__BBB___B
B_________________________________________B
B______BB__________________BB_____________B
B____________BB___________________BB______B
B_________________________________________B
B____BB___________________BB______________B
B_________________________________________B
BBBBBBBBBBBBBTTTttTTTBBBBBBBBBttTTTBBBBBBBB