B_________________________________________B
B_________________________________________B
B_________________________________________B
B_________________________________________B
B_________________________________________B
B_________________________________________B
B______E__________________________________B
BP_____BBBBBBBBBTtTBBBBBBBBBBBB___________B
B_________________________________________B
B_____________TTBB_______BB________BB_____B
B_________________________________________B
B______________________________BB_________B
B_____BB_____________BB____BB_____________B
B______________TBBBBB______________TB_____B
B____________________BBBBBTTt_____________B
B_________________________________________B
B___________BBB______________________BBB__B
B_________________________________________B
B_______BB__________________BB____________B
B_____________BB___________________BB_____B
B_________________________________________B
B_____BB___________________BB_____________B
B_________________________________________B
BBBBBBBBBBBBBttTTTTTTBBBBBBBBBTTTttBBBBBBBB